save = Save
search = Search
date = Date
time = Time
team = Team|Teams
extension = Extension|Extensions
flag = Flag|Flags
number = Number
duration = Duration
actions = Actions
general = General
description = Description
synchronize = Synchronize
cancel = Cancel
all = All
none = None
select = -- Select --
note = Note|Notes
call_type = Call Type
reference = Reference
rating = Rating
internal = Internal
incoming = Incoming
outgoing = Outgoing
search_by = Search By
delete = Delete
delete.confirmation = Are you sure, that you want delete this item?
delete.success = The item has been successfully removed
update.success = The data has been updated in the database
save.success = The data has been added to the database
new = New
send = Send
close = Close
error = Error
download = Download
name = Name
user = User|Users
password = Password
january = January
february = February
march = March
april = April
may = May
june = June
july = July
august = August
september = September
october = October
november = November
december = December
monday = Monday
tuesday = Tuesday
wednesday = Wednesday
thursday = Thursday
friday = Friday
saturday = Saturday
sunday = Sunday
username = Username
username.validation = Please enter your username
password.validation = Please enter your password
login = Login
wizard.title = Admin Password
password.retype = Retype Password
password.retype.validation.required = Please retype your password
password.retype.validation.equalTo = Please enter the same value again
accept = Accept
no_data_avail = No data Available
sign_in = Sign In
language = Language
logout = Logout
no_info = No Info
update = Update
yes = Yes
no = No
add = Add
change = Change
remove = Remove
select_image = Select Image
warning_msg = %s Warning
number.abbr = No.
option = Option|Options